Group_ID	Region	Time	Pop
Anatolia_Arslantepe_LC	Anatolia	Chalcolithic	Chalco
Anatolia_Buyukkaya_EC	Anatolia	Chalcolithic	Chalco
Anatolia_C	Anatolia	Chalcolithic	Chalco
Anatolia_CamlibelTarlasi_LC	Anatolia	Chalcolithic	Chalco
Anatolia_Ikiztepe_LC	Anatolia	Chalcolithic	Chalco
Anatolia_TellKurdu_EC	Anatolia	Chalcolithic	Chalco
Anatolia_TellKurdu_EMC	Anatolia	Chalcolithic	Chalco
Anatolia_Arslantepe_EBA	Anatolia	EMBA	BA
Anatolia_EBA	Anatolia	EMBA	BA
Anatolia_EBA.SG	Anatolia	EMBA	BA
Anatolia_TitrisHoyuk_EBA	Anatolia	EMBA	BA
Anatolia_Alalakh_MLBA	Anatolia	MLBA	BA
Anatolia_Alalakh_MLBA_outlier	Anatolia	MLBA	BA
Anatolia_MLBA.SG	Anatolia	MLBA	BA
Anatolia_Boncuklu_N.SG	Anatolia	Neolithic	Neo
Anatolia_Kumtepe_N.SG	Anatolia	Neolithic	Neo
Anatolia_N	Anatolia	Neolithic	Neo
Anatolia_N.SG	Anatolia	Neolithic	Neo
Anatolia_TepecikCiftlik_N.SG	Anatolia	Neolithic	Neo
Anatolia_TepecikCiftlik_N_o.SG	Anatolia	Neolithic	Neo
Anatolia_Epipaleolithic	Anatolia	Paleolithic	Epipaleo
Iran_C_HajjiFiruz	Iran 	Chalcolithic	Chalco
Iran_C_SehGabi	Iran 	Chalcolithic	Chalco
Iran_C_TepeHissar	Iran 	Chalcolithic	Chalco
Iran_Mesolithic_BeltCave	Iran 	Mesolithic	Meso
Iran_Mesolithic_HotuIIIb	Iran 	Mesolithic	Meso
Iran_GanjDareh_N	Iran 	Neolithic	Neo
Iran_LN_SehGabi	Iran 	Neolithic	Neo
Iran_TepeAbdulHosein_N.SG	Iran 	Neolithic	Neo
Iran_Wezmeh_N.SG	Iran 	Neolithic	Neo
Israel_C	Levant	Chalcolithic	Chalco
Jordan_EBA	Levant	EMBA	BA
Syria_Ebla_EMBA	Levant	EMBA	BA
Israel_Natufian	Levant	Mesolithic	Natufian
Israel_LBA_Ashkelon	Levant	MLBA	BA
Israel_MLBA	Levant	MLBA	BA
Lebanon_MLBA_Canaanite_MBA.SG	Levant	MLBA	BA
Israel_Middle_Late_PPNB	Levant	Neolithic	PPN
Israel_PPNB	Levant	Neolithic	PPN
Jordan_Late_PPNB	Levant	Neolithic	PPN
Jordan_PPNB	Levant	Neolithic	PPN
Jordan_PPNC	Levant	Neolithic	PPN
ISR_Natufian_EpiP	Levant	Paleolithic	Natufian
IRQ_Bestansur_PPN	Mesopotamia	Neolithic	Neo
IRQ_Shanidar_N	Mesopotamia	Neolithic	Neo
IRQ_Nemrik9_PPN	Mesopotamia	Neolithic	Neo
IRQ_PPN_lc	Mesopotamia	Neolithic	Neo
TUR_SE_Mardin_PPN	Mesopotamia	Neolithic	Neo
Russia_Caucasus_KuraAraxes	NCaucasus	EMBA	KuraAraxes
Russia_Caucasus_LateMaikop	NCaucasus	EMBA	Maikop
Russia_Caucasus_Maikop	NCaucasus	EMBA	Maikop
Russia_Caucasus_Maikop_Novosvobodnaya	NCaucasus	EMBA	Maikop
Russia_LateMaikop	NCaucasus	EMBA	Maikop
Russia_Steppe_Maikop	NCaucasus	EMBA	Maikop
Russia_Steppe_Maikop_o	NCaucasus	EMBA	Maikop
Russia_Caucasus_LBA_Dolmen	NCaucasus	MLBA	BA
Russia_North_Caucasus	NCaucasus	MLBA	BA
Russia_North_Caucasus_MBA	NCaucasus	MLBA	BA
Russia_Caucasus_Eneolithic	NCaucasus	Neolithic	Cauca_EN
Armenia_C	SCaucasus	Chalcolithic	Armenia_C
Caucasus_lowlands_LC	SCaucasus	Chalcolithic	LateC
Armenia_Caucasus_EBA_KuraAraxes	SCaucasus	EMBA	KuraAraxes
Armenia_EBA	SCaucasus	EMBA	EBA
ARM_Berkaber_KuraAraxes_EBA	SCaucasus	EMBA	KuraAraxes
ARM_Karnut_KuraAraxes_EBA	SCaucasus	EMBA	KuraAraxes
ARM_Shengavit_KuraAraxes_EBA	SCaucasus	EMBA	KuraAraxes
ARM_Tavshut_Trialeti_MBA	SCaucasus	MLBA	MLBA
ARM_Tekhut_LBA	SCaucasus	MLBA	MLBA
ARM_Agarak_Mdv	SCaucasus	Historical	Med
ARM_Aghitu_Anc	SCaucasus	IronAge	IronAge
ARM_Bagheri_Tchala_EIA	SCaucasus	IronAge	IronAge
ARM_Bover_EIA	SCaucasus	IronAge	IronAge
ARM_Bover_Urartian	SCaucasus	IronAge	IronAge
ARM_Bragdzor_EIA	SCaucasus	IronAge	IronAge
ARM_Bragdzor_EIA_lc	SCaucasus	IronAge	IronAge
ARM_Brardzryal_Urartian	SCaucasus	IronAge	IronAge
ARM_Harjis_LateUrartian	SCaucasus	IronAge	IronAge
ARM_Karashamb_EIA	SCaucasus	IronAge	IronAge
ARM_Karmir_Blur_Anc	SCaucasus	IronAge	IronAge
ARM_Karmir_Blur_EIA	SCaucasus	IronAge	IronAge
ARM_Karmir_Blur_Urartian	SCaucasus	IronAge	IronAge
ARM_Karmir_Blur_Urartian_outlier	SCaucasus	IronAge	IronAge
ARM_Karnut_EIA	SCaucasus	IronAge	IronAge
ARM_Keti_Anc	SCaucasus	IronAge	IronAge
ARM_Keti_EIA	SCaucasus	IronAge	IronAge
ARM_Lori_Berd_LateUrartian_A	SCaucasus	IronAge	IronAge
ARM_Lori_Berd_LateUrartian_B	SCaucasus	IronAge	IronAge
ARM_Noratus_Anc	SCaucasus	IronAge	IronAge
ARM_Noratus_EIA	SCaucasus	IronAge	IronAge
ARM_Pijut_Urartian	SCaucasus	IronAge	IronAge
ARM_Sarukhan_Anc	SCaucasus	IronAge	IronAge
ARM_Sarukhan_EIA	SCaucasus	IronAge	IronAge
ARM_Sarukhan_unknown	SCaucasus	IronAge	IronAge
Armenia_LBA.SG	SCaucasus	MLBA	MLBA
Armenia_LchashenMetsamor.SG	SCaucasus	MLBA	MLBA
Armenia_MBA	SCaucasus	MLBA	MLBA
Armenia_MBA.SG	SCaucasus	MLBA	MLBA
ARM_Black_Fortress_LBA	SCaucasus	MLBA	MLBA
ARM_Dzori_Gekh_LBA	SCaucasus	MLBA	MLBA
ARM_Karashamb_LBA	SCaucasus	MLBA	MLBA
ARM_Keti_LBA	SCaucasus	MLBA	MLBA
ARM_Keti_Urartian	SCaucasus	IronAge	IronAge
ARM_Lchashen_LBA	SCaucasus	MLBA	MLBA
ARM_Lori_Berd_LBA	SCaucasus	MLBA	MLBA
ARM_Lori_Berd_LBA_lc	SCaucasus	MLBA	MLBA
ARM_Nerkin_Getashen_LBA	SCaucasus	MLBA	MLBA
ARM_Nerkin_Getashen_LBA_outlier	SCaucasus	MLBA	MLBA
ARM_Noratus_LBA	SCaucasus	MLBA	MLBA
ARM_Pijut_LBA	SCaucasus	MLBA	MLBA
ARM_Sarukhan_LBA	SCaucasus	MLBA	MLBA
ARM_Yerevan2_unknown	SCaucasus	MLBA	MLBA
Mentesh	SCaucasus	Neolithic	Mentesh
Caucasus_lowlands_LN	SCaucasus	Neolithic	Neo
ARM_Aknashen_N	SCaucasus	Neolithic	Neo
ARM_Masis_Blur_N	SCaucasus	Neolithic	Neo
Georgia_Kotias.SG	SCaucasus	Paleolithic	CHG
Georgia_Satsurblia.SG	SCaucasus	Paleolithic	CHG
Russia_Caucasus_EBA_Yamnaya	Steppe	EMBA	Yamnaya
Russia_EBA_Yamnaya_Kalmykia.SG	Steppe	EMBA	Yamnaya
Russia_EBA_Yamnaya_Samara	Steppe	EMBA	Yamnaya
Russia_Kalmykia_EBA_Yamnaya.SG	Steppe	EMBA	Yamnaya
Ukraine_EBA_Yamnaya	Steppe	EMBA	Yamnaya
Ukraine_EBA_Yamnaya.SG	Steppe	EMBA	Yamnaya
Ukraine_Ozera_EBA_Yamnaya	Steppe	EMBA	Yamnaya
Russia_Steppe_Eneolithic	Steppe	Neolithic	Neolithic
Russia_EHG	Steppe	Paleolithic	EEHG
Russia_HG	Steppe	Paleolithic	EEHG
Russia_HG_Karelia	Steppe	Paleolithic	EEHG
Russia_HG_Samara	Steppe	Paleolithic	EEHG
Russia_Popovo_HG	Steppe	Paleolithic	EEHG
Russia_Sidelkino_HG.SG	Steppe	Paleolithic	EEHG
Russia_HG_Sosnoviy	Steppe	Paleolithic	WSHG
Russia_HG_Tyumen	Steppe	Paleolithic	WSHG