Group_ID	Region	Time
Afghanistan_DarraIKur_MBA	SouthAsia	MLBA
Anatolia_Alalakh_MLBA	Anatolia	MLBA
Anatolia_Alalakh_MLBA_outlier	Anatolia	MLBA
Anatolia_Arslantepe_EBA	Anatolia	EMBA
Anatolia_Arslantepe_LC	Anatolia	Chalcolithic
Anatolia_Boncuklu_N.SG	Anatolia	Neolithic
Anatolia_Buyukkaya_EC	Anatolia	Chalcolithic
Anatolia_C	Anatolia	Chalcolithic
Anatolia_CamlibelTarlasi_LC	Anatolia	Chalcolithic
Anatolia_EBA	Anatolia	EMBA
Anatolia_EBA.SG	Anatolia	EMBA
Anatolia_Epipaleolithic	Anatolia	Paleolithic
Anatolia_IA.SG	Anatolia	IronAge
Anatolia_Ikiztepe_LC	Anatolia	Chalcolithic
Anatolia_Kumtepe_N.SG	Anatolia	Neolithic
Anatolia_MLBA.SG	Anatolia	MLBA
Anatolia_N	Anatolia	Neolithic
Anatolia_N.SG	Anatolia	Neolithic
Anatolia_Ottoman_1.SG	Anatolia	Historical
Anatolia_Ottoman_2.SG	Anatolia	Historical
Anatolia_TellKurdu_EC	Anatolia	Chalcolithic
Anatolia_TellKurdu_EMC	Anatolia	Chalcolithic
Anatolia_TepecikCiftlik_N.SG	Anatolia	Neolithic
Anatolia_TepecikCiftlik_N_o.SG	Anatolia	Neolithic
Anatolia_TitrisHoyuk_EBA	Anatolia	EMBA
Armenia_C	Caucasus	Chalcolithic
Armenia_Caucasus_EBA_KuraAraxes	Caucasus	EMBA
Armenia_EBA	Caucasus	EMBA
Armenia_LBA.SG	Caucasus	MLBA
Armenia_LchashenMetsamor.SG	Caucasus	MLBA
Armenia_MBA	Caucasus	MLBA
Armenia_MBA.SG	Caucasus	MLBA
Austria_EN_LBK	Europe	Neolithic
Austria_KremsWA3	Europe	Paleolithic
Belgium_UP_GoyetQ116_1	Europe	Paleolithic
Belgium_UP_GoyetQ-2	Europe	Paleolithic
Belgium_UP_GoyetQ376-19	Europe	Paleolithic
Belgium_UP_Magdalenian	Europe	Paleolithic
Bulgaria_BeliBreyag_EBA	Europe	EMBA
Bulgaria_C	Europe	Chalcolithic
Bulgaria_EBA	Europe	EMBA
Bulgaria_EBA_Ezero	Europe	EMBA
Bulgaria_EBA_Yamnaya_o	WesternSteppe	EMBA
Bulgaria_IA	Europe	IronAge
Bulgaria_MLBA	Europe	MLBA
Bulgaria_N	Europe	Neolithic
Bulgaria_Varna_C	Europe	Chalcolithic
Caucasus_lowlands_LC	Caucasus	Chalcolithic
Caucasus_lowlands_LN	Caucasus	Neolithic
Croatia_EIA	Europe	IronAge
Croatia_EN_Impressa	Europe	Neolithic
Croatia_EN_Starcevo	Europe	Neolithic
Croatia_LateC_EBA_Vucedol	Europe	EMBA
Croatia_LN_Starcevo	Europe	Neolithic
Croatia_MBA	Europe	EMBA
Croatia_Mesolithic_HG	Europe	Mesolithic
Croatia_MN_Sopot	Europe	Neolithic
Croatia_N_Cardial	Europe	Neolithic
Croatia_Vucedol	Europe	Neolithic
Czech_BA	Europe	EMBA
Czech_Baalberge	Europe	Neolithic
Czech_BellBeaker	Europe	EMBA
Czech_CordedWare	Europe	Neolithic
Czech_EarlySlav.SG	Europe	Historical
Czech_EBA	Europe	EMBA
Czech_EBA_Protounetice	Europe	EMBA
Czech_EBA_Unetice	Europe	EMBA
Czech_Eneolithic	Europe	Neolithic
Czech_HallstattBylany.SG	Europe	IronAge
Czech_Megalithic.SG	Europe	Neolithic
Czech_MN	Europe	Neolithic
Czech_N	Europe	Neolithic
Czech_Pavlov1	Europe	Paleolithic
Czech_Vestonice13	Europe	Paleolithic
Czech_Vestonice15	Europe	Paleolithic
Czech_Vestonice16	Europe	Paleolithic
Czech_Vestonice43	Europe	Paleolithic
Denmark_BA.SG	Europe	EMBA
Denmark_LBA.SG	Europe	MLBA
Denmark_LN.SG	Europe	Neolithic
Denmark_MN_B.SG	Europe	Neolithic
DevilsCave_N.SG	EasternSteppe	Neolithic
England_BellBeaker	Europe	EMBA
England_C_EBA	Europe	EMBA
England_IA.SG	Europe	IronAge
England_LBA	Europe	MLBA
England_LIA.SG	Europe	IronAge
England_LIA_ERoman.SG	Europe	IronAge
England_MBA	Europe	MLBA
England_Mesolithic	Europe	Mesolithic
England_Mesolithic_all.SG	Europe	Mesolithic
England_N	Europe	Neolithic
England_N.SG	Europe	Neolithic
England_N_possible	Europe	Neolithic
England_Roman.SG	Europe	Historical
England_Saxon.SG	Europe	Historical
Estonia_BA.SG	Europe	EMBA
Estonia_BA_o.SG	Europe	EMBA
Estonia_CordedWare.SG	Europe	Neolithic
Estonia_CWC	Europe	Neolithic
Estonia_EMN_Narva	Europe	Neolithic
Estonia_IA.SG	Europe	IronAge
Estonia_Medieval.SG	Europe	Historical
Estonia_MN_CCC	Europe	Neolithic
France_BellBeaker	Europe	EMBA
France_BellBeaker_lowSteppe	Europe	EMBA
France_BerryAuBac	Europe	Neolithic
France_Paleo	Europe	Paleolithic
France_MN	Europe	Neolithic
Georgia_Kotias.SG	Caucasus	Paleolithic
Georgia_Satsurblia.SG	Caucasus	Paleolithic
Germany_BellBeaker	Europe	EMBA
Germany_Bockstein	Europe	Paleolithic
Germany_Burkhardtshohle	Europe	Paleolithic
Germany_CordedWare	Europe	Neolithic
Germany_CordedWare.SG	Europe	Neolithic
Germany_EBA_Unetice	Europe	EMBA
Germany_EMedieval.SG	Europe	Historical
Germany_EN_LBK	Europe	Neolithic
Germany_EN_LBK_Stuttgart.DG	Europe	Neolithic
Germany_Falkenstein	Europe	Paleolithic
Germany_HohleFels49	Europe	Paleolithic
Germany_LBA_Halberstadt	Europe	MLBA
Germany_Lech_EBA	Europe	EMBA
Germany_Lech_MBA	Europe	MLBA
Germany_LN	Europe	Neolithic
Germany_LRoman.SG	Europe	Historical
Germany_MN	Europe	Neolithic
Germany_MN_Blatterhohle	Europe	Neolithic
Gibraltar_BA	Europe	EMBA
Gibraltar_N	Europe	Neolithic
Greece_BA_Mycenaean	Europe	MLBA
Greece_Crete_Armenoi	Europe	EMBA
Greece_Minoan	Europe	EMBA
Greece_N	Europe	Neolithic
Greece_N.SG	Europe	Neolithic
Greece_Peloponnese_N	Europe	Neolithic
Hungary_AvarPeriod	Europe	IronAge
Hungary_AvarPeriod.SG	Europe	IronAge
Hungary_C_Balaton_Lasinja	Europe	Chalcolithic
Hungary_EarlyC_Tiszapolgar	Europe	Chalcolithic
Hungary_EBA_BellBeaker	Europe	EMBA
Hungary_EBA_Mako	Europe	EMBA
Hungary_EBA_Protonagyrev	Europe	EMBA
Hungary_EN_HG_Koros	Europe	Neolithic
Hungary_EN_Koros	Europe	Neolithic
Hungary_EN_Starcevo	Europe	Neolithic
Hungary_Langobard	Europe	Historical
Hungary_Langobard.SG	Europe	Historical
Hungary_LateC_Baden	Europe	Chalcolithic
Hungary_LateC_Protoboleraz	Europe	Chalcolithic
Hungary_LBA.SG	Europe	MLBA
Hungary_LBK_MN.SG	Europe	Neolithic
Hungary_LC_EBA_Baden_Yamnaya	Europe	EMBA
Hungary_LN_Lengyel	Europe	Neolithic
Hungary_LN_Sopot	Europe	Neolithic
Hungary_LN_Tisza	Europe	Neolithic
Hungary_Maros_EBA.SG	Europe	EMBA
Hungary_MBA_Vatya.SG	Europe	EMBA
Hungary_Medieval.SG	Europe	Historical
Hungary_MN	Europe	Neolithic
Hungary_MN_LBK	Europe	Neolithic
Hungary_MN_Vinca	Europe	Neolithic
Hungary_Prescythian_IA.SG	WesternSteppe	IronAge
Hungary_Scythian.SG	WesternSteppe	IronAge
Iberia_BA	Europe	EMBA
Iberia_BA.SG	Europe	EMBA
Iberia_BA_Cogotas	Europe	EMBA
Iberia_BellBeaker	Europe	EMBA
Iberia_C	Europe	Chalcolithic
Iberia_C.SG	Europe	Chalcolithic
Iberia_C_BA	Europe	Chalcolithic
Iberia_Carolingian	Europe	Historical
Iberia_Celtiberian	Europe	IronAge
Iberia_EBA	Europe	EMBA
Iberia_ElMiron	Europe	Paleolithic
Iberia_EN	Europe	Neolithic
Iberia_EN.SG	Europe	Neolithic
Iberia_EN_Cardial	Europe	Neolithic
Iberia_EN_Epicardial	Europe	Neolithic
Iberia_Greek	Europe	IronAge
Iberia_Greek1	Europe	IronAge
Iberia_Greek2	Europe	IronAge
Iberia_Hellenistic	Europe	Historical
Iberia_Hellenistic_B	Europe	Historical
Iberia_HG	Europe	Paleolithic
Iberia_HG.SG	Europe	Paleolithic
Iberia_IA	Europe	IronAge
Iberia_IA_PreIberian	Europe	IronAge
Iberia_Iberian	Europe	IronAge
Iberia_Islamic	Europe	Historical
Iberia_LBA	Europe	MLBA
Iberia_LBA_Cogotas	Europe	MLBA
Iberia_LN	Europe	Neolithic
Iberia_LN.SG	Europe	Neolithic
Iberia_LRoman_Medieval	Europe	Historical
Iberia_MBA	Europe	MLBA
Iberia_MBA.SG	Europe	MLBA
Iberia_Medieval	Europe	Historical
Iberia_MN	Europe	Neolithic
Iberia_MN.SG	Europe	Neolithic
Iberia_Muslim	Europe	Historical
Iberia_North_BA_Africa	Europe	EMBA
Iberia_Roman	Europe	Historical
Iberia_UP_Azilian	Europe	Paleolithic
Iberia_Visigoth	Europe	Historical
Ibiza_Punic.SG	Europe	IronAge
Iceland_Early_Christian.SG	Europe	Historical
Iceland_Pre_Christian.SG	Europe	Historical
India_Harappan	SouthAsia	MLBA
India_RoopkundA	SouthAsia	Historical
India_RoopkundB	SouthAsia	Historical
India_RoopkundC	SouthAsia	Historical
Indian_GreatAndaman_100BP.SG	SouthAsia	Historical
Iran_BA_HajjiFiruz	Iran 	EMBA
Iran_BA1_ShahrISokhta	Turan	EMBA
Iran_BA2_ShahrISokhta	SouthAsia	EMBA
Iran_BA3_ShahrISokhta	Turan	EMBA
Iran_C_HajjiFiruz	Iran 	Chalcolithic
Iran_C_SehGabi	Iran 	Chalcolithic
Iran_C_TepeHissar	Iran 	Chalcolithic
Iran_GanjDareh_N	Iran 	Neolithic
Iran_Historic_GanjDareh	Iran 	Historical
Iran_IA_HajjiFiruz	Iran 	IronAge
Iran_IA_Hasanlu.SG	Iran 	IronAge
Iran_LN_SehGabi	Iran 	Neolithic
Iran_Mesolithic_BeltCave	Iran 	Mesolithic
Iran_Mesolithic_HotuIIIb	Iran 	Mesolithic
Iran_TepeAbdulHosein_N.SG	Iran 	Neolithic
Iran_Wezmeh_N.SG	Iran 	Neolithic
Ireland_BA.SG	Europe	EMBA
Ireland_MN.SG	Europe	Neolithic
Israel_C	Levant	Chalcolithic
Israel_IA1_Ashkelon	Levant	IronAge
Israel_IA2_Ashkelon	Levant	IronAge
Israel_LBA_Ashkelon	Levant	MLBA
Israel_Middle_Late_PPNB	Levant	Neolithic
Israel_MLBA	Levant	MLBA
Israel_Natufian	Levant	Mesolithic
Israel_PPNB	Levant	Neolithic
Italy_C.SG	Europe	Chalcolithic
Italy_C_BA.SG	Europe	Chalcolithic
Italy_IA_Republic.SG	Europe	IronAge
Italy_IA_Republic_oEasternMediterranean.SG	Europe	IronAge
Italy_Imperial.SG	Europe	Historical
Italy_Imperial_oAfrican.SG	Europe	Historical
Italy_Imperial_oCentralEuropean.SG	Europe	Historical
Italy_LA.SG	Europe	Historical
Italy_LA_oCentralEuropean.SG	Europe	Historical
Italy_LA_oSardiniaLike.SG	Europe	Historical
Italy_Medieval_EarlyModern.SG	Europe	Historical
Italy_Med_EarlyModern_oCEuropean.SG	Europe	Historical
Italy_Mesolithic.SG	Europe	Mesolithic
Italy_N.SG	Europe	Neolithic
Italy_N_oWHG.SG	Europe	Neolithic
Italy_North_BellBeaker	Europe	EMBA
Italy_North_EarlyMedieval_Langobards	Europe	Historical
Italy_North_Remedello_C.SG	Europe	Chalcolithic
Italy_North_Remedello_EBA.SG	Europe	EMBA
Italy_North_Villabruna_HG	Europe	Paleolithic
Italy_Sicily_C_o	Europe	Chalcolithic
Italy_Sicily_HG_OrienteC	Europe	Paleolithic
Italy_South_HG_Ostuni1	Europe	Paleolithic
Italy_South_HG_Ostuni2	Europe	Paleolithic
Italy_South_HG_Paglicci133	Europe	Paleolithic
Jordan_EBA	Levant	EMBA
Jordan_Late_PPNB	Levant	Neolithic
Jordan_PPNB	Levant	Neolithic
Jordan_PPNC	Levant	Neolithic
Kazakhstan_Andronovo.SG	CentralSteppe	MLBA
Kazakhstan_BA_Zevakinskiy	CentralSteppe	EMBA
Kazakhstan_Botai.SG	CentralSteppe	EMBA
Kazakhstan_CentralSaka.SG	CentralSteppe	MLBA
Kazakhstan_CentralSteppe_EMBA.SG	CentralSteppe	EMBA
Kazakhstan_CentralTasmola_o1.SG	CentralSteppe	IronAge
Kazakhstan_CentralTasmola_o2.SG	CentralSteppe	IronAge
Kazakhstan_Chanchar_MBA	Steppe	EMBA
Kazakhstan_Dali_EBA	Steppe	EMBA
Kazakhstan_EBA_Yamnaya.SG	WesternSteppe	EMBA
Kazakhstan_EIA_Birlik.SG	CentralSteppe	IronAge
Kazakhstan_Eneolithic_Botai.SG	CentralSteppe	EMBA
Kazakhstan_Georgievsky_MBA	CentralSteppe	EMBA
Kazakhstan_GoldenHordeAsian.SG	EasternSteppe	Historical
Kazakhstan_GoldenHordeEuro.SG	WesternSteppe	Historical
Kazakhstan_His.SG	CentralSteppe	Historical
Kazakhstan_IA_Berel_Pazyryk	EasternSteppe	IronAge
Kazakhstan_IA_Chanchar	Steppe	IronAge
Kazakhstan_IA_Tasbas	Steppe	IronAge
Kazakhstan_IA_ZevakinoChilikta_1.SG	EasternSteppe	IronAge
Kazakhstan_IA_ZevakinoChilikta_2.SG	EasternSteppe	IronAge
Kazakhstan_Kanai_MBA	Steppe	EMBA
Kazakhstan_Kangju.SG	CentralSteppe	Historical
Kazakhstan_Karakhanid.SG	CentralSteppe	Historical
Kazakhstan_Karluk.SG	CentralSteppe	Historical
Kazakhstan_Kimak.SG	CentralSteppe	Historical
Kazakhstan_Kipchak1.SG	CentralSteppe	Historical
Kazakhstan_Kipchak2.SG	CentralSteppe	Historical
Kazakhstan_Kumsay_EBA	Steppe	EMBA
Kazakhstan_LBA	CentralSteppe	MLBA
Kazakhstan_LBA_Guruldek	CentralSteppe	MLBA
Kazakhstan_LBA_Molaly	CentralSteppe	MLBA
Kazakhstan_LBA_Tasbas	CentralSteppe	MLBA
Kazakhstan_LBA_Zevakinskiy	CentralSteppe	MLBA
Kazakhstan_LIA_Georgievsky	CentralSteppe	IronAge
Kazakhstan_Medieval_Nomad.SG	EasternSteppe	Historical
Kazakhstan_Mereke_MBA	WesternSteppe	EMBA
Kazakhstan_MLBA_Aktogai	WesternSteppe	MLBA
Kazakhstan_MLBA_Alakul_Lisakovskiy	WesternSteppe	MLBA
Kazakhstan_MLBA_Alakul_Maitan	WesternSteppe	MLBA
Kazakhstan_MLBA_Alakul_Maitan_o	WesternSteppe	MLBA
Kazakhstan_MLBA_Alakul_Satan	WesternSteppe	MLBA
Kazakhstan_MLBA_Bylkyldak	WesternSteppe	MLBA
Kazakhstan_MLBA_Dali	Steppe	MLBA
Kazakhstan_MLBA_Fedorovo_Shoendykol	CentralSteppe	MLBA
Kazakhstan_MLBA_Fedorovo_Shoindykol	CentralSteppe	MLBA
Kazakhstan_MLBA_Kairan	WesternSteppe	MLBA
Kazakhstan_MLBA_Kairan_o	WesternSteppe	MLBA
Kazakhstan_MLBA_Karagash	WesternSteppe	MLBA
Kazakhstan_MLBA_KazakhMys	CentralSteppe	MLBA
Kazakhstan_MLBA_OyDzhaylau	WesternSteppe	MLBA
Kazakhstan_MLBA_OyDzhaylau_o	WesternSteppe	MLBA
Kazakhstan_MLBA_Solyanka	WesternSteppe	MLBA
Kazakhstan_MLBA_Zevakinskiy	CentralSteppe	MLBA
Kazakhstan_MLBA1_AkMoustafa	WesternSteppe	MLBA
Kazakhstan_MLBA1_Kyzlbulak	CentralSteppe	MLBA
Kazakhstan_MLBA1_Taldysay	CentralSteppe	MLBA
Kazakhstan_MLBA2_Kyzlbulak	CentralSteppe	MLBA
Kazakhstan_MLBA2_Taldysay	CentralSteppe	MLBA
Kazakhstan_Nomad_HP.SG	EasternSteppe	Historical
Kazakhstan_Nomad_Hun_Sarmatian.SG	EasternSteppe	Historical
Kazakhstan_Nomad_IA.SG	CentralSteppe	IronAge
Kazakhstan_OutCentralSaka.SG	CentralSteppe	MLBA
Kazakhstan_OutTianShanHun.SG	CentralSteppe	Historical
Kazakhstan_OutTurk.SG	CentralSteppe	Historical
Kazakhstan_Sarmatian.SG	WesternSteppe	IronAge
Kazakhstan_Sintashta_MLBA_o.SG	CentralSteppe	MLBA
Kazakhstan_TianShanSaka.SG	CentralSteppe	IronAge
Kazakhstan_Turk.SG	CentralSteppe	Historical
Kazakhstan_Wusun.SG	CentralSteppe	Historical
Kazakhstan_Wusun_2.SG	CentralSteppe	Historical
Kolyma_M.SG	EasternSteppe	Mesolithic
Kyrgyzstan_BA_Aygirdjal	Steppe	MLBA
Kyrgyzstan_Medieval_Nomad.SG	EasternSteppe	Historical
Kyrgyzstan_Nomad_modern.SG	CentralSteppe	Historical
Kyrgyzstan_OutTianShanSaka.SG	CentralSteppe	IronAge
Kyrgyzstan_TianShanHun.SG	CentralSteppe	Historical
Kyrgyzstan_TianShanSaka.SG	CentralSteppe	IronAge
Kyrgyzstan_Turk.SG	CentralSteppe	Historical
Latvia_BA	Europe	EMBA
Latvia_HG	Europe	Paleolithic
Latvia_HG.SG	Europe	Paleolithic
Latvia_MN	Europe	Neolithic
Lebanon_Medieval.SG	Levant	Historical
Lebanon_Medieval_o1.SG	Levant	Historical
Lebanon_Medieval_o2.SG	Levant	Historical
Lebanon_Medieval_o3.SG	Levant	Historical
Lebanon_Medieval_o4.SG	Levant	Historical
Lebanon_Medieval_o6.SG	Levant	Historical
Lebanon_MLBA_Canaanite_MBA.SG	Levant	MLBA
Lebanon_Roman.SG	Levant	Historical
Lithuania_BA	Europe	MLBA
Lithuania_EMN_Narva	Europe	Neolithic
Lithuania_Late_Antiquity.SG	Europe	Historical
Lithuania_LBA.SG	Europe	MLBA
Lithuania_LN	Europe	Neolithic
Lithuania_Mesolithic	Europe	Mesolithic
Luxembourg_Loschbour.DG	Europe	Paleolithic
Macedonia_N	Europe	Neolithic
Magadan_BA.SG	EasternSteppe	MLBA
Mentesh	Caucasus	Neolithic
Moldova_Cimmerian.SG	WesternSteppe	IronAge
Moldova_Scythian.SG	WesternSteppe	IronAge
Mongolia_Afanasievo_Mongolia	WesternSteppe	EMBA
Mongolia_Altai_MLBA	EasternSteppe	MLBA
Mongolia_centralMongolia_preBA	EasternSteppe	EMBA
Mongolia_Chandman_IA	EasternSteppe	IronAge
Mongolia_earlyXiongnu_o	EasternSteppe	IronAge
Mongolia_earlyXiongnu_rest	EasternSteppe	IronAge
Mongolia_earlyXiongnu_west	WesternSteppe	IronAge
Mongolia_eastMongolia_preBA	EasternSteppe	EMBA
Mongolia_EMBA_Chemurchek_northAlai	EasternSteppe	EMBA
Mongolia_EMBA_Chemurchek_southAltai	CentralSteppe	EMBA
Mongolia_IA_o	EasternSteppe	IronAge
Mongolia_IA_Ulaanzuukh_SlabGrave	EasternSteppe	IronAge
Mongolia_Khovsgol_LBA	EasternSteppe	MLBA
Mongolia_lateXiongnu	EasternSteppe	IronAge
Mongolia_lateXiongnu_han	EasternSteppe	IronAge
Mongolia_lateXiongnu_o	EasternSteppe	IronAge
Mongolia_lateXiongnu_sarmatian	WesternSteppe	IronAge
Mongolia_MLBA_o	EasternSteppe	MLBA
Mongolia_MLBA_Ulaanzuukh_SlabGrave	EasternSteppe	MLBA
Mongolia_XiongNu.SG	EasternSteppe	IronAge
Mongolia_XiongNu_WE.SG	WesternSteppe	IronAge
Montenegro_IA.SG	Europe	IronAge
Montenegro_LBA.SG	Europe	MLBA
Nepal_Chokhopani_2700BP.SG	SouthAsia	EMBA
Nepal_Mebrak_2125BP.SG	SouthAsia	EMBA
Nepal_Samdzong_1500BP.SG	SouthAsia	MLBA
Netherlands_BA	Europe	EMBA
Netherlands_BellBeaker	Europe	EMBA
Norway_Mesolithic.SG	Europe	Mesolithic
Norway_N_HG.SG	Europe	Neolithic
Pakistan_H_Aligrama	SouthAsia	Historical
Pakistan_H_Barikot	SouthAsia	Historical
Pakistan_H_Butkara	SouthAsia	Historical
Pakistan_H_SaiduSharif	SouthAsia	Historical
Pakistan_H_SaiduSharif_o	SouthAsia	Historical
Pakistan_IA_Aligrama2	SouthAsia	IronAge
Pakistan_IA_Arkotkila	SouthAsia	IronAge
Pakistan_IA_Barikot	SouthAsia	IronAge
Pakistan_IA_Butkara	SouthAsia	IronAge
Pakistan_IA_Gogdara	SouthAsia	IronAge
Pakistan_IA_Katelai	SouthAsia	IronAge
Pakistan_IA_Loebanr	SouthAsia	IronAge
Pakistan_IA_Udegram	SouthAsia	IronAge
Pakistan_IA_Udegram_o	SouthAsia	IronAge
Pakistan_LBA	SouthAsia	MLBA
Pakistan_MBA_LIA	SouthAsia	MLBA
Pakistan_Medieval_Barikot2	SouthAsia	Historical
Pakistan_Medieval_Parwak	SouthAsia	Historical
Pakistan_Medieval_RajaGira	SouthAsia	Historical
Pakistan_Medieval_Singoor	SouthAsia	Historical
Pakistan_Medieval_Udegram_Ghaznavid	SouthAsia	Historical
Poland_BellBeaker	Europe	EMBA
Poland_BKG.SG	Europe	Neolithic
Poland_BKG_o1.SG	Europe	Neolithic
Poland_BKG_o2.SG	Europe	Neolithic
Poland_ChopiceVeseleCulture	Europe	Neolithic
Poland_CordedWare.SG	Europe	Neolithic
Poland_CordedWare_ProtoUnetice.SG	Europe	Neolithic
Poland_CWC	Europe	Neolithic
Poland_CWC.SG	Europe	Neolithic
Poland_CWC_o.SG	Europe	EMBA
Poland_EBA	Europe	EMBA
Poland_EBA.SG	Europe	EMBA
Poland_GAC.SG	Europe	Neolithic
Poland_Globular_Amphora	Europe	Neolithic
Poland_Koszyce_GAC.SG	Europe	Neolithic
Poland_Ksiaznice_GAC.SG	Europe	Neolithic
Poland_Mierzanowice_GAC.SG	Europe	Neolithic
Poland_Sandomierz_GAC.SG	Europe	Neolithic
Poland_TRB.SG	Europe	Neolithic
Poland_Unetice_EBA.SG	Europe	EMBA
Portugal_Geometric_Mesolithic	Europe	Mesolithic
Romania_C	Europe	Chalcolithic
Romania_C.SG	Europe	Chalcolithic
Romania_EN	Europe	Neolithic
Romania_Mesolithic	Europe	Mesolithic
Romania_Mesolithic_IronGates	Europe	Mesolithic
Romania_Mesolithic_IronGates.SG	Europe	Mesolithic
Romania_Muierii2	Europe	Paleolithic
Romania_Oase1	Europe	Paleolithic
Russia_Afanasievo	WesternSteppe	EMBA
Russia_Afanasievo.SG	WesternSteppe	EMBA
Russia_AfontovaGora2.SG	Baikal	Paleolithic
Russia_AfontovaGora3	Baikal	Paleolithic
Russia_Alan.SG	Caucasus	Historical
Russia_Alan_o.SG	Caucasus	Historical
Russia_Andronovo.SG	CentralSteppe	MLBA
Russia_BA_Okunevo.SG	EasternSteppe	EMBA
Russia_Bolshoy	Steppe	MLBA
Russia_Caucasus_EBA_Yamnaya	WesternSteppe	EMBA
Russia_Caucasus_Eneolithic	Caucasus	Neolithic
Russia_Caucasus_KuraAraxes	Caucasus	EMBA
Russia_Caucasus_LateMaikop	Caucasus	EMBA
Russia_Caucasus_LBA_Dolmen	Caucasus	MLBA
Russia_Caucasus_Maikop	Caucasus	EMBA
Russia_Caucasus_Maikop_Novosvobodnaya	Caucasus	EMBA
Russia_Chalmny_Varre	Steppe	Historical
Russia_Early_Sarmatian.SG	WesternSteppe	IronAge
Russia_EarlySarmatian_SouthernUrals.SG	WesternSteppe	IronAge
Russia_EasternScythian_SouthernUrals.SG	EasternSteppe	IronAge
Russia_EasternScythian_SouthernUrals_o.SG	EasternSteppe	IronAge
Russia_EBA.SG	Steppe	EMBA
Russia_EBA_Yamnaya_Kalmykia.SG	WesternSteppe	EMBA
Russia_EBA_Yamnaya_Samara	WesternSteppe	EMBA
Russia_EHG	Steppe	Paleolithic
Russia_Fofonovo_EN	Baikal	Neolithic
Russia_HG	Steppe	Paleolithic
Russia_HG_Karelia	Steppe	Paleolithic
Russia_HG_Samara	Steppe	Paleolithic
Russia_HG_Sosnoviy	Steppe	Paleolithic
Russia_HG_Tyumen	Steppe	Paleolithic
Russia_IA.SG	Steppe	IronAge
Russia_IA_EarlySarmatian	WesternSteppe	IronAge
Russia_IA_Scythian_questionable	WesternSteppe	IronAge
Russia_IA_Ulaanzuukh_SlabGrave	EasternSteppe	IronAge
Russia_Kalmykia_EBA_Yamnaya.SG	WesternSteppe	EMBA
Russia_Karasuk.SG	CentralSteppe	MLBA
Russia_Karasuk_o.SG	CentralSteppe	MLBA
Russia_Khvalynsk_Eneolithic	Steppe	Neolithic
Russia_Kostenki12	Steppe	Paleolithic
Russia_Kostenki14	Steppe	Paleolithic
Russia_Kurma_EBA.SG	EasternSteppe	EMBA
Russia_Late_Sarmatian.SG	WesternSteppe	IronAge
Russia_LateMaikop	Caucasus	EMBA
Russia_lateXiongnu	EasternSteppe	IronAge
Russia_LBA.SG	Steppe	MLBA
Russia_LBA_Priobrazhenka	Steppe	MLBA
Russia_Lokomotiv_Eneolithic.SG	EasternSteppe	Neolithic
Russia_MA1_HG.SG	Steppe	Paleolithic
Russia_Medieval_Nomad.SG	EasternSteppe	Historical
Russia_Medieval_UstBelaya_Angara	EasternSteppe	Historical
Russia_Mezhovskaya.SG	WesternSteppe	MLBA
Russia_MiddleSarmatian_SouthernUrals.SG	WesternSteppe	IronAge
Russia_MLBA_Krasnoyarsk	CentralSteppe	MLBA
Russia_MLBA_Potapovka	WesternSteppe	MLBA
Russia_MLBA_Priobrazhenka	WesternSteppe	MLBA
Russia_MLBA_Sintashta	CentralSteppe	MLBA
Russia_North_Caucasus	Caucasus	MLBA
Russia_North_Caucasus_MBA	Caucasus	MLBA
Russia_OldBeringSea_Ekven	EasternSteppe	Historical
Russia_OldBeringSea_Uelen	EasternSteppe	Historical
Russia_Petrovka	WesternSteppe	MLBA
Russia_Poltavka	WesternSteppe	MLBA
Russia_Popovo_HG	Steppe	Paleolithic
Russia_Potapovka	WesternSteppe	MLBA
Russia_SaltovoMayaki.SG	Caucasus	Historical
Russia_Sarmatian.SG	WesternSteppe	IronAge
Russia_Shamanka_EBA.SG	Baikal	EMBA
Russia_Shamanka_Eneolithic.SG	Baikal	Neolithic
Russia_Sidelkino_HG.SG	Steppe	Paleolithic
Russia_Sintashta_MLBA.SG	CentralSteppe	MLBA
Russia_Srubnaya	WesternSteppe	MLBA
Russia_Srubnaya_Alakul.SG	WesternSteppe	MLBA
Russia_Steppe_Catacomb	WesternSteppe	Neolithic
Russia_Steppe_Eneolithic	Steppe	Neolithic
Russia_Steppe_Lola	Caucasus	MLBA
Russia_Steppe_Maikop	Caucasus	EMBA
Russia_Steppe_Maikop_o	Caucasus	EMBA
Russia_Sunghir.SG	Steppe	Paleolithic
Russia_Tagar.SG	CentralSteppe	IronAge
Russia_Tuva_IA_AldyBel	EasternSteppe	IronAge
Russia_Uelen_IA.SG	EasternSteppe	IronAge
Russia_Ust_Ishim_HG.DG	Baikal	Paleolithic
Russia_UstBelaya_Angara	Baikal	Neolithic
Russia_UstIda_EBA.SG	Baikal	EMBA
Russia_UstIda_LN.SG	Baikal	Neolithic
Saami_IA.SG	Europe	IronAge
Scotland_BellBeaker	Europe	EMBA
Scotland_C_EBA	Europe	EMBA
Scotland_LBA	Europe	MLBA
Scotland_MBA	Europe	MLBA
Scotland_Megalithic.SG	Europe	Neolithic
Scotland_N	Europe	Neolithic
Scotland_N.SG	Europe	Neolithic
Serbia_EN	Europe	Neolithic
Serbia_Medieval_Gepidian.SG	Europe	Historical
Serbia_Mesolithic_IronGates	Europe	Mesolithic
Serbia_N	Europe	Neolithic
Slovakia_Poprad.SG	Europe	Historical
Sweden_BA.SG	Europe	MLBA
Sweden_BAC	Europe	Chalcolithic
Sweden_BattleAxe.SG	Europe	Chalcolithic
Sweden_FBC	Europe	Chalcolithic
Sweden_HG.SG	Europe	Mesolithic
Sweden_HG_Motala	Europe	Mesolithic
Sweden_HG_Motala.SG	Europe	Mesolithic
Sweden_IA.SG	Europe	IronAge
Sweden_LN.SG	Europe	Neolithic
Sweden_LNBA	Europe	Neolithic
Sweden_Megalithic	Europe	Neolithic
Sweden_Megalithic.SG	Europe	Neolithic
Sweden_Mesolithic.SG	Europe	Mesolithic
Sweden_Motala_HG	Europe	Paleolithic
Sweden_PWC	Europe	Neolithic
Sweden_PWC_NHG.SG	Europe	Neolithic
Sweden_TRB_MN	Europe	Neolithic
Sweden_TRB_MN.SG	Europe	Neolithic
Sweden_Viking.SG	Europe	Historical
Switzerland_BellBeaker	Europe	EMBA
Switzerland_Bichon.SG	Europe	Paleolithic
Syria_Ebla_EMBA	Levant	EMBA
Tajikistan_BA_DashtiKozy	Turan	EMBA
Tajikistan_C_Sarazm	Turan	Chalcolithic
Tajikistan_Ksirov_Kushan	Turan	IronAge
Turkmenistan_C_Geoksyur	Turan	Chalcolithic
Turkmenistan_C_Namazga.SG	Turan	Chalcolithic
Turkmenistan_C_Namazga_o.SG	Turan	Chalcolithic
Turkmenistan_C_Parkhai	Turan	Chalcolithic
Turkmenistan_C_TepeAnau	Turan	Chalcolithic
Turkmenistan_EBA_Parkhai	Turan	EMBA
Turkmenistan_Gonur_BA_1	Turan	EMBA
Turkmenistan_Gonur_BA_1_o	Turan	EMBA
Turkmenistan_Gonur_BA_1_o2	Turan	EMBA
Turkmenistan_Gonur_BA_2	SouthAsia	EMBA
Turkmenistan_Gonur_BA_3	Turan	EMBA
Turkmenistan_Gonur_BA_4	Turan	EMBA
Turkmenistan_Gonur_BA	Turan	EMBA
Turkmenistan_IA.SG	Turan	IronAge
Turkmenistan_LBA_Parkhai	Turan	MLBA
Turkmenistan_LBA_Parkhai_o	Turan	MLBA
Turkmenistan_LBA_Sumbar	Turan	MLBA
Turkmenistan_Parkhai_MBA	Turan	MLBA
Ukraine_BA_Catacomb.SG	WesternSteppe	EMBA
Ukraine_Chernyakhiv.SG	WesternSteppe	IronAge
Ukraine_Chernyakhiv_o.SG	WesternSteppe	IronAge
Ukraine_Cimmerians.SG	WesternSteppe	IronAge
Ukraine_Cimmerians_o1.SG	WesternSteppe	IronAge
Ukraine_Cimmerians_o2.SG	WesternSteppe	IronAge
Ukraine_EBA_GlobularAmphora	Europe	EMBA
Ukraine_EBA	Europe	EMBA
Ukraine_EBA_Yamnaya	WesternSteppe	EMBA
Ukraine_EBA_Yamnaya.SG	WesternSteppe	EMBA
Ukraine_Eneolithic	Europe	Neolithic
Ukraine_Eneolithic_SredniStog	Europe	Neolithic
Ukraine_Eneolithic_SredniStog_o4	Europe	Neolithic
Ukraine_Eneolithic_Trypillia	Europe	Neolithic
Ukraine_Globular_Amphora	Europe	Neolithic
Ukraine_IA_WesternScythian.SG	WesternSteppe	IronAge
Ukraine_IA_WesternScythian_o.SG	WesternSteppe	IronAge
Ukraine_LateSrubnaya.SG	WesternSteppe	MLBA
Ukraine_Mesolithic	Europe	Mesolithic
Ukraine_N	Europe	Neolithic
Ukraine_Ozera_EBA_Yamnaya	WesternSteppe	EMBA
Ukraine_Scythian.SG	WesternSteppe	IronAge
Ukraine_Scythian.WGC	WesternSteppe	IronAge
UstBelaya_EBA.SG	Baikal	EMBA
UstBelaya_MED.SG	Baikal	Historical
UstBelaya_N.SG	Baikal	Neolithic
Uzbekistan_BA_Bustan	Turan	EMBA
Uzbekistan_BA_Bustan_o1	Turan	EMBA
Uzbekistan_BA_Bustan_o2	Turan	EMBA
Uzbekistan_BA_Dzharkutan1	Turan	EMBA
Uzbekistan_BA_Dzharkutan2	Turan	EMBA
Uzbekistan_BA_Kashkarchi	Turan	EMBA
Uzbekistan_BA_Kokcha	Turan	EMBA
Uzbekistan_BA_SappaliTepe	Turan	EMBA
Uzbekistan_BA_SappaliTepe_o	Turan	EMBA
Uzbekistan_BA_SappaliTepe2	Turan	EMBA
Uzbekistan_Bustan_Eneolithic	Turan	Neolithic
Uzbekistan_ZamanBaba_N	Turan	Neolithic
Yana_Medieval.SG	EasternSteppe	Historical
Yana_UP.SG	Steppe	Paleolithic
Abazin	Caucasus	Modern
Abkhasian	Caucasus	Modern
Adygei	Caucasus	Modern
Altaian	Baikal	Modern
Altaian_Chelkan	Baikal	Modern
Armenian	Europe	Modern
Armenian_Hemsheni	Europe	Modern
Assyrian	Levant	Modern
Avar	Caucasus	Modern
Azeri	Caucasus	Modern
Balkar	Caucasus	Modern
Balochi	SouthAsia	Modern
Bashkir	EasternSteppe	Modern
Basque	Europe	Modern
BedouinA	Levant	Modern
BedouinB	Levant	Modern
Besermyan	EasternSteppe	Modern
Brahui	SouthAsia	Modern
Burusho	SouthAsia	Modern
Buryat	Baikal	Modern
Cambodian	EastAsia	Modern
Chechen	Caucasus	Modern
China_Lahu	EastAsia	Modern
Chuvash	Baikal	Modern
Circassian	Caucasus	Modern
Dai	EastAsia	Modern
Darginian	Caucasus	Modern
Daur	EastAsia	Modern
Druze	Levant	Modern
Evenk_FarEast	EasternSteppe	Modern
Evenk_Transbaikal	EasternSteppe	Modern
Ezid	Caucasus	Modern
French	Europe	Modern
Georgian	Caucasus	Modern
Han	EastAsia	Modern
Hazara	SouthAsia	Modern
Hezhen	EastAsia	Modern
Ingushian	Caucasus	Modern
Iranian	Iran	Modern
Iranian_Bandari	Iran	Modern
Italian_North	Europe	Modern
Japanese	EastAsia	Modern
Jew_Georgian	Caucasus	Modern
Jew_Iranian	Iran	Modern
Jew_Iraqi	Levant	Modern
Jew_Turkish	Anatolia	Modern
Kabardinian	Caucasus	Modern
Kaitag	Caucasus	Modern
Kalash	SouthAsia	Modern
Kalmyk	EasternSteppe	Modern
Karachai	Caucasus	Modern
Karelian	EasternSteppe	Modern
Kazakh	EasternSteppe	Modern
Khakass	Baikal	Modern
Khakass_Kachin	Baikal	Modern
Khamnegan	EasternSteppe	Modern
Kubachinian	Caucasus	Modern
Kumyk	Caucasus	Modern
Kurd	Caucasus	Modern
Lak	Caucasus	Modern
Makrani	SouthAsia	Modern
Miao	EastAsia	Modern
Mongola	Baikal	Modern
Mordovian	Europe	Modern
Nanai	EasternSteppe	Modern
Naxi	EastAsia	Modern
Negidal	EasternSteppe	Modern
Nivh	EasternSteppe	Modern
Nogai_Astrakhan	CentralSteppe	Modern
Nogai_Karachay_Cherkessia	CentralSteppe	Modern
Nogai_Stavropol	CentralSteppe	Modern
Orcadian	Europe	Modern
Oroqen	EastAsia	Modern
Ossetian	Caucasus	Modern
Palestinian	Levant	Modern
Pathan	SouthAsia	Modern
Russian	CentralSteppe	Modern
Russian_Archangelsk_Krasnoborsky	CentralSteppe	Modern
Russian_Archangelsk_Leshukonsky	CentralSteppe	Modern
Russian_Archangelsk_Pinezhsky	CentralSteppe	Modern
Sardinian	Europe	Modern
She	EastAsia	Modern
Shor_Khakassia	Baikal	Modern
Shor_Mountain	Baikal	Modern
Sindhi_Pakistan	SouthAsia	Modern
Syrian	Levant	Modern
Tabasaran	Caucasus	Modern
Tatar_Kazan	CentralSteppe	Modern
Tatar_Mishar	CentralSteppe	Modern
Tatar_Siberian	CentralSteppe	Modern
Tatar_Siberian_Zabolotniye	CentralSteppe	Modern
Todzin	EasternSteppe	Modern
Tu	EastAsia	Modern
Tubalar	Baikal	Modern
Tujia	EastAsia	Modern
Turkish	Anatolia	Modern
Turkish_Balikesir	Anatolia	Modern
Tuvinian	EasternSteppe	Modern
Udmurt	CentralSteppe	Modern
Uyghur	CentralSteppe	Modern
Veps	Caucasus	Modern
Xibo	EastAsia	Modern
Yakut	EasternSteppe	Modern
Yi	EastAsia	Modern
Lezgin	Caucasus	Modern
IRN_HajjiFiruz_ChL	Iran	Chalcolithic
IRN_TepeHissar_ChL	Iran	Chalcolithic
TUR_Marmara_Barcın_ChL	Anatolia	Chalcolithic
TUR_Marmara_Ilıpınar_ChL	Anatolia	Chalcolithic
TUR_SE_Batman_ChL	Anatolia	Chalcolithic
TUR_SE_Kilis_ChL	Anatolia	Chalcolithic
TUR_SE_Şırnak_ChL_A	Anatolia	Chalcolithic
TUR_SE_Şırnak_ChL_B	Anatolia	Chalcolithic
TUR_SE_Şırnak_ChL_C	Anatolia	Chalcolithic
ARM_Berkaber_KuraAraxes_EBA	Caucasus	EMBA
ARM_Karnut_KuraAraxes_EBA	Caucasus	EMBA
ARM_Karnut_KuraAraxes_EBA_lc	Caucasus	EMBA
ARM_Shengavit_KuraAraxes_EBA	Caucasus	EMBA
ARM_Tavshut_Trialeti_MBA	Caucasus	EMBA
ARM_Tekhut_LBA	Caucasus	EMBA
TUR_Aegean_Izmir_Yassıtepe_EBA	Anatolia	EMBA
TUR_BA_lc	Anatolia	EMBA
TUR_BlackSea_Amasya_EBA	Anatolia	EMBA
TUR_EBA_lc	Anatolia	EMBA
TUR_SE_Gaziantep_BA	Anatolia	EMBA
TUR_SE_Kilis_EBA_A	Anatolia	EMBA
TUR_SE_Şırnak_BA	Anatolia	EMBA
ARM_Agarak_Mdv	Caucasus	Historical
TUR_Aegean_Muğla_Camandras_Dalagöz_Rom	Anatolia	Historical
TUR_Aegean_Muğla_Çapalıbağ_Mdv	Anatolia	Historical
TUR_Aegean_Muğla_Samantaş_Byz	Anatolia	Historical
TUR_Aegean_Muğla_Stratonikeia_Byz	Anatolia	Historical
TUR_Hellenistic_lc	Anatolia	Historical
TUR_Marmara_Apollonia_Rom	Anatolia	Historical
TUR_Marmara_Balıkesir_Byz	Anatolia	Historical
TUR_Marmara_Balıkesir_PostMdv	Anatolia	Historical
TUR_Marmara_Ilıpınar_Byz1	Anatolia	Historical
TUR_Marmara_Ilıpınar_Byz2	Anatolia	Historical
TUR_Marmara_Ilıpınar_Byz3	Anatolia	Historical
TUR_Marmara_İznik_Basilica_RomByz_A	Anatolia	Historical
TUR_Marmara_İznik_Basilica_RomByz_B	Anatolia	Historical
TUR_Marmara_İznik_Y.kapı_Byz	Anatolia	Historical
TUR_Marmara_İznik_Y.kapı_PostMdv	Anatolia	Historical
TUR_Roman_o_lc	Anatolia	Historical
TUR_SE_Gaziantep_Byz	Anatolia	Historical
TUR_SE_Kilis_Byz	Anatolia	Historical
TUR_SE_Mardin_PostMdv	Anatolia	Historical
TUR_SE_Mardin_RomByz	Anatolia	Historical
ARM_Aghitu_Anc	Caucasus	IronAge
ARM_Bagheri_Tchala_EIA	Caucasus	IronAge
ARM_Bover_EIA	Caucasus	IronAge
ARM_Bover_Urartian	Caucasus	IronAge
ARM_Bragdzor_EIA	Caucasus	IronAge
ARM_Bragdzor_EIA_lc	Caucasus	IronAge
ARM_Brardzryal_Urartian	Caucasus	IronAge
ARM_Harjis_LateUrartian	Caucasus	IronAge
ARM_Karashamb_EIA	Caucasus	IronAge
ARM_Karmir_Blur_Anc	Caucasus	IronAge
ARM_Karmir_Blur_EIA	Caucasus	IronAge
ARM_Karmir_Blur_Urartian	Caucasus	IronAge
ARM_Karmir_Blur_Urartian_outlier	Caucasus	IronAge
ARM_Karnut_EIA	Caucasus	IronAge
ARM_Keti_Anc	Caucasus	IronAge
ARM_Keti_EIA	Caucasus	IronAge
ARM_Lori_Berd_LateUrartian_A	Caucasus	IronAge
ARM_Lori_Berd_LateUrartian_B	Caucasus	IronAge
ARM_Noratus_Anc	Caucasus	IronAge
ARM_Noratus_EIA	Caucasus	IronAge
ARM_Pijut_Urartian	Caucasus	IronAge
ARM_Sarukhan_Anc	Caucasus	IronAge
ARM_Sarukhan_EIA	Caucasus	IronAge
IRN_DinkhaTepe_BIA_A	Iran	IronAge
IRN_DinkhaTepe_BIA_B	Iran	IronAge
IRN_HajjiFiruz_IA	Iran	IronAge
IRN_Hasanlu_IA	Iran	IronAge
TUR_Aegean_Bodrum_Halikarnassos_Anc1	Anatolia	IronAge
TUR_Aegean_Bodrum_Halikarnassos_Anc2	Anatolia	IronAge
TUR_Aegean_Bodrum_Halikarnassos_Anc3	Anatolia	IronAge
TUR_Aegean_Muğla_Değirmendere_Anc	Anatolia	IronAge
TUR_BlackSea_Samsun_Anc_A	Anatolia	IronAge
TUR_BlackSea_Samsun_Anc_B	Anatolia	IronAge
TUR_BlackSea_Samsun_Anc_C	Anatolia	IronAge
TUR_C_Gordion_Anc	Anatolia	IronAge
TUR_E_Van_BIA_pre-Urartian	Anatolia	IronAge
TUR_E_Van_Urartian	Anatolia	IronAge
TUR_E_Van_Urartian_outlier	Anatolia	IronAge
TUR_IA_lc	Anatolia	IronAge
TUR_SE_Batman_Anc	Anatolia	IronAge
TUR_SE_Mardin_Anc	Anatolia	IronAge
IRN_Belt_Cave_Mes	Iran	Mesolithic
ARM_Black_Fortress_LBA	Caucasus	MLBA
ARM_Dzori_Gekh_LBA	Caucasus	MLBA
ARM_Karashamb_LBA	Caucasus	MLBA
ARM_Keti_LBA	Caucasus	MLBA
ARM_Keti_Urartian	Caucasus	MLBA
ARM_Lchashen_LBA	Caucasus	MLBA
ARM_Lori_Berd_LBA	Caucasus	MLBA
ARM_Lori_Berd_LBA_lc	Caucasus	MLBA
ARM_Nerkin_Getashen_LBA	Caucasus	MLBA
ARM_Nerkin_Getashen_LBA_outlier	Caucasus	MLBA
ARM_Noratus_LBA	Caucasus	MLBA
ARM_Pijut_LBA	Caucasus	MLBA
ARM_Sarukhan_LBA	Caucasus	MLBA
ARM_Yerevan2_unknown	Caucasus	MLBA
IRN_BA1_ShahrISokhta_lc	Iran	MLBA
IRN_HajjiFiruz_BA	Iran	MLBA
IRN_Hasanlu_LBA_A	Iran	MLBA
IRN_Hasanlu_LBA_B	Iran	MLBA
IRN_Hasanlu_MBA	Iran	MLBA
IRN_Shahr_I_Sokhta_BA	Iran	MLBA
IRN_ShahrISokhta_BA2_lc	Iran	MLBA
IRQ_Nemrik9_LBA	Mesopotamia	MLBA
TUR_Aegean_Izmir_Yassitepe_MBA	Anatolia	MLBA
TUR_MBA_lc	Anatolia	MLBA
TUR_Med_Isparta_BA	Anatolia	MLBA
TUR_SE_Kilis_MBA	Anatolia	MLBA
ARM_Sarukhan_unknown	Caucasus	IronAge
ARM_Aknashen_N	Caucasus	Neolithic
ARM_Masis_Blur_N	Caucasus	Neolithic
IRQ_Bestansur_PPN	Iran	Neolithic
IRQ_Nemrik9_PPN	Mesopotamia	Neolithic
IRQ_PPN_lc	Mesopotamia	Neolithic
IRQ_Shanidar_N	Iran	Neolithic
IRQ_Shanidar_N_outlier	Mesopotamia	Neolithic
JOR_PPNB	Levant	Neolithic
JOR_PPNC	Levant	Neolithic
TUR_Marmara_Barcin_N	Anatolia	Neolithic
TUR_Marmara_Barcın_N	Anatolia	Neolithic
TUR_Marmara_Ilıpınar_N	Anatolia	Neolithic
TUR_Marmara_Menteşe_N	Anatolia	Neolithic
TUR_PPN_lc	Anatolia	Neolithic
TUR_SE_Mardin_PPN	Mesopotamia	Neolithic
ISR_Natufian_EpiP	Levant	Paleolithic